  0   0   0   0   0   0   0   0   0   0   0 101   0   0   0   0   0   0   0   0   0   0   0   0   0   0   0   0   0   0   0   0
  0   0   0   0   0   0   0   0   0   0 100   1   0   0   0   0   0   0   0   0   0   0   0   0   0   0   0   0   1   0   0   0
  0   0   0   0   0   0   0   0   0   0 100   1   0   0   0   0   0   0   0   0   0   0   0   0   0   0   0   0   1   0   0   0
  0   0   0   0   0   0   0   0   0   0 100   1   0   0   0   0   0   0   0   0   0   0   0   0   0   0   0   0   1   0   0   0
  0   0   0   0   0   0   0   0   0   0 100   1   0   0   0   0   0   0   0   0   0   0   0   0   0   0   0   0   1   0   0   0
  1  -1   0   0   0   0   0   0  10   2   0   1   0   0   0 200   0   0   0   0   0   0   0   0 100   1   0   0   1   0  10   0
  1   1   1   0   1   0   0   1   1   1   1   1   1   1   0   1   1   1   1   0   3   3   3   3   3   1   1   1   1   1   1   1