  0   0   0   0   0   0   0   0   0   0   0   0   0   0   0   0   0   0
  0   0   0   0   0   0   0   0   0   0 101   0   0   0   0   0   0   0
  0   0   0   0   0   0   0   0   0   0   1   0   0   0   0   0   0   0
  0   0   0   0   0   0   0   0   0   0   1   0   0   0   0   0   0   0
  0   0   0   0   0   0   0   0   0   0   1   0   0   0   0   0   0   0
 -1   2   0   0   0 101   0 100   1   0   1   0   0   0   0   0   0   0
  1   1   1   1   1   1   1   1   1   3   3   3   3   1   1   1   1   1